11111111111111
1P0100000C0C01
10000111110001
100011E0000001
11111111111111