11111111111111
1P0100000001C1
10000111110111
100011E0000001
11111111111111