11111
1P0C1
11101
100E1
11111