1111111111111
1P0C0000000C1
1001000000001
1101000000001
1011000000001
100E000000001
1111111111111